10
2 2 2 1 2 2 2 2 2 2
2 3 4 2 2 2 2 2 2 1
2 1 2 2 8 2 2 1 6 1
2 1 3 1 7 1 8 1 2 2
0 2 2 4 2 1 1 1 2 1
1 1 1 1 1 1 1 2 2 5
1 3 4 2 1 1 1 2 2 1
1 1 2 2 2 2 2 2 2 1
1 1 3 2 1 2 1 1 1 1
2 1 2 4 2 2 1 1 1 1