5
5 2 4 2 7
2 8 2 1 2
3 2 4 2 3
2 1 2 8 2
0 2 4 2 6
