20
2 1 1 2 1 1 1 1 1 1 1 1 1 1 1 1 2 1 1 1
1 3 4 1 1 1 1 1 1 1 1 1 1 1 1 1 2 1 1 1
1 2 1 1 8 1 1 1 1 1 1 1 1 1 1 1 2 1 1 1
1 1 1 2 2 2 8 1 1 1 1 1 1 1 1 1 2 1 1 1
0 2 2 4 2 2 2 1 1 1 1 1 1 1 1 1 2 1 1 1
2 2 2 2 2 2 2 1 1 1 1 1 1 1 1 1 2 1 1 1
2 3 4 1 2 2 2 1 1 1 2 2 2 5 1 1 2 1 1 1
1 1 1 1 1 1 2 1 1 1 2 2 2 2 1 1 1 1 2 2
2 2 3 1 2 1 2 2 2 2 2 2 1 1 4 1 4 1 2 4
1 2 1 4 1 1 2 2 2 2 2 2 2 2 2 2 2 1 2 2
1 1 1 2 2 1 2 2 4 4 3 2 3 2 1 2 3 1 8 2
1 3 4 2 2 1 2 3 2 3 1 6 2 2 3 2 2 1 2 1
4 2 1 2 4 1 1 1 1 2 2 2 2 1 2 2 3 1 1 1
2 2 3 2 2 1 1 1 1 1 1 2 2 1 2 7 2 1 1 1
1 1 1 4 1 1 2 1 1 1 1 2 2 2 2 1 1 1 1 1
1 1 2 2 2 1 2 1 2 1 1 1 1 1 1 1 2 1 1 1
1 3 4 2 2 1 1 1 2 1 1 1 1 1 1 1 2 1 1 1
1 2 2 1 2 1 1 1 2 1 1 1 1 1 1 1 2 1 1 1
2 2 3 2 2 1 2 2 2 1 1 1 1 1 1 1 2 1 1 1
1 2 1 4 1 1 2 2 2 1 1 1 1 1 1 1 2 1 1 1