15
0 2 2 4 2 2 3 2 2 2 2 2 2 2 8
2 1 1 2 1 1 2 1 1 4 1 1 2 1 1
5 2 3 2 2 4 2 2 2 2 2 2 2 2 6
1 1 2 1 1 2 1 1 3 1 1 2 8 1 2
2 3 4 2 2 3 2 2 3 2 2 2 2 2 2
2 8 1 3 1 1 2 1 1 2 1 1 3 1 1
2 2 2 2 2 2 2 2 4 2 2 2 2 2 2
1 1 2 1 1 4 1 1 8 1 1 3 1 1 3
2 2 3 2 2 2 2 2 2 4 2 2 2 2 2
2 1 1 3 1 1 4 1 1 3 1 1 2 1 1
2 2 2 4 2 2 2 2 2 2 2 2 3 2 2
1 1 3 1 1 2 1 1 2 1 1 4 1 1 2
2 2 2 2 2 4 2 2 2 2 3 2 2 2 2
2 1 1 3 1 1 3 1 1 8 1 1 4 1 1
2 2 2 2 2 2 2 2 2 4 2 2 2 2 7