10
0 2 2 1 1 2 1 1 1 2
2 3 4 2 2 2 2 3 8 1
2 1 2 8 1 4 3 7 2 2
1 1 3 2 1 8 1 1 2 4
3 2 2 4 2 3 1 2 2 3
2 2 5 1 2 2 1 1 1 2
2 3 4 2 2 2 2 3 8 2
2 1 2 8 1 4 3 2 2 2
1 1 3 2 1 8 1 1 2 4
3 2 2 4 2 3 1 6 2 3