5
5 2 2 2 7
2 1 3 1 2
2 8 4 1 2
2 1 6 1 2
0 1 2 2 2
