20
0 1 2 1 1 1 1 1 1 1 1 1 1 1 1 1 1 1 1 2
2 1 2 2 2 2 3 2 2 2 2 2 2 2 2 2 3 2 2 2
2 1 2 1 1 2 1 1 1 2 2 1 1 1 1 2 1 1 1 2
2 1 2 2 2 2 3 2 2 2 2 2 2 2 2 2 3 2 2 2
2 1 2 1 1 2 1 1 1 4 2 1 1 1 1 2 1 1 1 2
2 1 2 4 2 2 2 2 2 2 3 2 2 2 2 2 3 2 8 2
2 2 2 3 8 2 2 2 2 2 2 2 2 2 2 2 2 2 2 2
1 2 1 2 1 2 1 2 1 2 1 2 1 2 1 4 1 4 1 2
4 2 2 2 7 2 2 2 2 2 2 2 2 2 2 2 2 2 2 2
2 1 3 1 2 1 8 2 1 2 1 5 2 1 2 2 1 2 2 8
2 1 4 1 2 1 2 2 1 2 2 1 2 2 1 4 2 1 2 2
2 2 2 2 2 2 2 2 6 2 4 2 2 2 2 2 2 2 2 2
2 2 2 2 2 2 3 2 1 1 2 2 1 1 1 2 2 1 1 2
2 1 2 1 3 1 2 2 2 2 3 2 1 2 2 4 2 2 2 2
2 1 2 1 2 1 2 2 1 1 2 2 2 1 2 2 2 1 2 2
2 2 2 2 2 2 3 2 2 2 1 2 2 2 1 2 2 1 1 2
2 2 2 4 2 2 2 2 1 2 2 1 2 2 2 1 2 2 2 2
2 1 2 1 2 1 2 2 2 2 2 2 1 2 2 2 1 2 2 2
2 1 2 1 2 1 2 2 1 8 2 1 2 1 1 2 2 1 1 2
4 2 2 2 2 2 2 2 2 4 2 2 2 2 2 4 2 2 2 2